"a" = (/turf/space,/area/space)
"b" = (/turf/space,/area/aisat)
"c" = (/turf/unsimulated/wall,/area/space)
"d" = (/turf/unsimulated/wall,/area/aisat)
"e" = (/turf/simulated/wall/titanium,/area/admin)
"f" = (/turf/unsimulated/wall,/area/admin)
"g" = (/obj/structure/closet/secure_closet/freezer/fridge,/turf/simulated/floor/tiled/white,/area/admin)
"h" = (/obj/machinery/light{dir = 1},/turf/simulated/floor/tiled/white,/area/admin)
"i" = (/turf/simulated/floor/tiled/white,/area/admin)
"j" = (/obj/structure/toilet{icon_state = "toilet00"; dir = 8},/turf/simulated/floor/tiled/white,/area/admin)
"k" = (/obj/machinery/light/spot{icon_state = "tube1"; dir = 1},/turf/simulated/floor/grass,/area/admin)
"l" = (/obj/machinery/light/spot{icon_state = "tube1"; dir = 1},/turf/simulated/floor/grass,/area/aisat)
"m" = (/obj/machinery/light/spot{icon_state = "tube1"; dir = 1},/turf/simulated/floor/grass,/area/space)
"n" = (/obj/machinery/light/spot{icon_state = "tube1"; dir = 1},/obj/machinery/light/spot{icon_state = "tube1"; dir = 4},/turf/simulated/floor/grass,/area/space)
"o" = (/obj/structure/table/marble,/turf/simulated/floor/tiled/white,/area/admin)
"p" = (/obj/machinery/door/airlock,/turf/simulated/floor/tiled/white,/area/admin)
"q" = (/turf/simulated/floor/grass,/area/admin)
"r" = (/turf/simulated/floor/grass,/area/aisat)
"s" = (/turf/simulated/floor/grass,/area/space)
"t" = (/obj/machinery/light/spot{icon_state = "tube1"; dir = 4},/turf/simulated/floor/grass,/area/space)
"u" = (/obj/machinery/alarm{dir = 4; icon_state = "alarm0"; pixel_x = -22},/turf/simulated/floor/tiled/white,/area/admin)
"v" = (/obj/machinery/light{icon_state = "tube1"; dir = 4},/obj/structure/table/marble,/turf/simulated/floor/tiled/white,/area/admin)
"w" = (/obj/structure/stairs/north,/turf/simulated/floor/wood,/area/admin)
"x" = (/obj/structure/mirror{pixel_x = 32},/obj/structure/sink{dir = 4; icon_state = "sink"; pixel_x = 12},/turf/simulated/floor/tiled/white,/area/admin)
"y" = (/turf/simulated/floor/wood,/area/admin)
"z" = (/obj/structure/table/marble,/obj/structure/window/basic,/turf/simulated/floor/tiled/white,/area/admin)
"A" = (/obj/machinery/door/airlock{name = "Restroom"},/turf/simulated/floor/tiled/white,/area/admin)
"B" = (/obj/machinery/light{dir = 1},/turf/simulated/floor/wood,/area/admin)
"C" = (/obj/machinery/light{icon_state = "tube1"; dir = 8},/turf/simulated/floor/wood,/area/admin)
"D" = (/obj/machinery/alarm{dir = 4; icon_state = "alarm0"; pixel_x = -22},/turf/simulated/floor/wood,/area/admin)
"E" = (/turf/simulated/floor/carpet,/area/admin)
"F" = (/obj/machinery/power/apc{dir = 4; name = "east bump"; pixel_x = -24},/obj/machinery/power/terminal{icon_state = "term"; dir = 8},/obj/machinery/power/fractal_reactor{density = 0; invisibility = 101},/turf/simulated/floor/tiled/dark,/area/admin)
"G" = (/obj/structure/table/rack,/obj/machinery/light/small{icon_state = "bulb1"; dir = 8},/turf/simulated/floor/tiled/dark,/area/admin)
"H" = (/obj/structure/simple_door/wood,/turf/simulated/floor/tiled/dark,/area/admin)
"I" = (/obj/structure/coatrack,/turf/simulated/floor/wood,/area/admin)
"J" = (/obj/machinery/light/flamp,/turf/simulated/floor/carpet,/area/admin)
"K" = (/obj/effect/landmark{name = "JoinLate"},/turf/simulated/floor/wood,/area/admin)
"L" = (/obj/machinery/light/spot,/turf/simulated/floor/grass,/area/admin)
"M" = (/obj/machinery/light/spot,/turf/simulated/floor/grass,/area/space)
"N" = (/obj/machinery/light/spot{icon_state = "tube1"; dir = 4},/obj/machinery/light/spot,/turf/simulated/floor/grass,/area/space)

(1,1,1) = {"
aaaaaaaaaaaaaaaaaaaaaaaaaaaaaaaa
aaaaaaaaaaaaaaaaaaaaaaaaaaaaaaaa
aaaaaaaaaaaaaaaaaaaaaaaaaaaaaaaa
aaaaaaaaaaaaaaaaaaaaaaaaaaaaaaaa
aaaaaaaaaaaaaaaaaaaaaaaaaaaaaaaa
aaaaaaaaaaaaaaaaaaaaaaaaaaaaaaaa
aaaaaaaaaaaaaaaaaaaaaaaaaaaaaaaa
aaaaaaaaaaaaaaaaaaaaaaaaaaaaaaaa
aaaaaaaaaaaaaaaaaaaaaaaaaaaaaaaa
aaaaaaaabbbbbbbbbbbbbbbaaaaaaaaa
aaaaaaaabbbbbbbbbbbbbbbaaaaaaaaa
aaaaaaaabbbbbbbbbbbbbbbaaaaaaaaa
aaaaaaaabbbbbbbbbbbbbbbaaaaaaaaa
ccccccccddbbbbbbbbbbbbbaaaaaaaaa
eeeeeeeeeffffffddddddddcccccccca
eghiieijekkkkkkllllllllmmmmmmnca
eoiiiepeeeeqqqqrrrrrrrrsssssstca
eoiiieuveweqqqqrrrrrrrrsssssstca
eoiiieixeyeqqqqrrrrrrrrsssssstca
eiizzeAeeyeeeeerrrrrrrrsssssstca
eyyyyyyyByByyyerrrrrrrrsssssstca
eyyyyyyyyyyyyyerrrrrrrrsssssstca
eCyyyyyyyyyyyyerrrrrrrrsssssstca
eyyyyyyyyyyyyyerrrrrrrrsssssstca
eDyyyyyyyyyyyyerrrrsssssssssstca
eeeyyyyEEEEEEEerrrrsssssssssstca
eFeyyyyEEEEEEEerrrrsssssssssstca
eGHyyIyEEEEEEJerrrrsssssssssstca
eeeyyeeeeeeeeeerrrrsssssssssstca
ffeKKeqqqqqqqqqrrrrsssssssssstca
ffeKKeLLLLLLLLLMMMMMMMMMMMMMMNca
fffffffffffffffcccccccccccccccca
"}
